x x x x x x x x x x
x 07 06 05 x 01 x 38 x x
x 08 x 04 03 02 19 20 x x
x 09 x x x x x 21 x x
x 10 x 18 x 34 x 22 23 x
x 11 12 17 x 33 32 x 24 x
x x 13 x x x 27 26 25 x
x x 14 x 30 29 28 x 35 x
x 16 15 x 31 x x 37 36 x
x x x x x x x x x x
